item_name,spent,received_post_tax,tax_paid,profit,closed_quantity,closed_timestamp
"Dragon pickaxe",5824200,5849510,119375,25310,5,2025-08-08T01:56:56Z
"Lumbridge teleport",798512,844580,0,46068,1396,2025-08-08T01:46:38Z
"Wilderness crabs teleport",1283295,1306968,26637,23673,39,2025-08-08T01:44:11Z
"Wrath rune",7450000,7525000,150000,75000,25000,2025-08-08T01:35:07Z
"Snape grass seed",1860600,1896333,38667,35733,200,2025-08-08T01:15:51Z
"Runite bolts",1650000,1694000,33000,44000,11000,2025-08-08T01:08:49Z
"Demon tear",2912000,3068000,52000,156000,13000,2025-08-08T01:02:56Z
"Adamant dart",440000,484000,0,44000,11000,2025-08-08T01:01:10Z
"Zulrah's scales",5940000,6000000,120000,60000,30000,2025-08-08T01:01:05Z
"Trouver parchment",8779355,8853962,180687,74607,13,2025-08-08T00:58:35Z
"Revenant ether",5250000,5220000,90000,-30000,30000,2025-08-08T00:53:24Z
"Coal",2275000,2288000,39000,13000,13000,2025-08-08T00:53:13Z
"Sarachnis cudgel",100255,104592,2134,4337,1,2025-08-08T00:53:03Z
"Nature rune",1656000,1692000,18000,36000,18000,2025-08-08T00:44:50Z
"Cannonball",2079000,2112000,33000,33000,11000,2025-08-08T00:44:20Z
"Iron ore",1327277,1337728,20902,10451,10451,2025-08-08T00:40:09Z
"Rune arrow",1193962,1217221,23259,23259,7753,2025-08-08T00:33:40Z
"Demon tear",1412167,1393504,24884,-18663,6221,2025-08-08T00:31:33Z
"Divine ranging potion(4)",5998254,6130716,125103,132462,669,2025-08-08T00:30:37Z
"Blood rune",5175000,5250000,100000,75000,25000,2025-08-08T00:30:21Z
"Blue moon spear",362560,380220,7758,17660,2,2025-08-07T22:49:38Z
"Phoenix necklace",2784255,2772942,56565,-11313,1257,2025-08-07T22:47:41Z
"Eclipse atlatl",1819624,1832350,37394,12726,1,2025-08-07T22:37:04Z
"Monkfish",4518648,4673928,93168,155280,7764,2025-08-07T22:32:44Z
"Law rune",2052000,2070000,36000,18000,18000,2025-08-07T22:29:38Z
"Chaos rune",1296000,1314000,18000,18000,18000,2025-08-07T22:27:41Z
"Death rune",3575000,3625000,50000,50000,25000,2025-08-07T22:15:19Z
"Steel bar",2263715,2309498,45783,45783,5087,2025-08-07T22:14:22Z
"Dharok's platebody",1334980,1354524,27642,19544,2,2025-08-07T22:14:02Z
"Iron ore",318625,326272,5098,7647,2549,2025-08-07T22:13:48Z
"Rune arrow",506532,519520,9741,12988,3247,2025-08-07T22:12:19Z
"Gold bar",1190000,1220000,20000,30000,10000,2025-08-07T21:54:17Z
"Brimstone ring",5267155,5363458,109458,96303,1,2025-08-07T21:51:17Z
"Cosmic rune",1242000,1242000,18000,0,18000,2025-08-07T21:49:52Z
"Astral rune",160660,168970,2770,8310,2770,2025-08-07T21:28:14Z
"Dragonfire shield",7744676,7737282,157902,-7394,2,2025-08-07T21:24:16Z
"Dragon boots",6243885,6304068,128628,60183,27,2025-08-07T21:19:16Z
"Yew logs",2436000,2472000,48000,36000,12000,2025-08-07T21:14:03Z
"Dragon axe",573112,580176,11840,7064,8,2025-08-07T21:07:08Z
"Ruby bolts (e)",194750,205000,4100,10250,2050,2025-08-07T21:00:04Z
"Cooked karambwan",2027740,2034830,38995,7090,3545,2025-08-07T20:46:17Z
"Dagon'hai robes set",2978375,2922633,59645,-55742,1,2025-08-07T20:38:50Z
"Adamant bolts",731405,754502,7699,23097,7699,2025-08-07T20:34:20Z
"Cannonball",2057000,2112000,33000,55000,11000,2025-08-07T20:25:38Z
"Coal",2275000,2314000,39000,39000,13000,2025-08-07T20:23:57Z
"Blighted karambwan",1182612,1216644,17016,34032,8508,2025-08-07T20:23:02Z
"Demon tear",1471043,1565949,27116,94906,6779,2025-08-07T20:15:02Z
"Blood rune",5175000,5250000,100000,75000,25000,2025-08-07T20:04:27Z
"Nature rune",1638000,1674000,18000,36000,18000,2025-08-07T20:04:15Z
"Runite bolts",1639000,1716000,33000,77000,11000,2025-08-07T20:01:02Z
"Grapes",1100000,1140000,20000,40000,20000,2025-08-07T20:00:25Z
"Red chinchompa",5854464,5908672,115192,54208,6776,2025-08-07T19:30:01Z
"Adamant dart",418000,484000,0,66000,11000,2025-08-07T19:06:45Z
"Astral rune",1078155,1127916,16587,49761,16587,2025-08-07T19:01:15Z
"White berries",1561557,1611447,29934,49890,4989,2025-08-07T18:40:17Z
"Zulrah's scales",5910000,5970000,120000,60000,30000,2025-08-07T18:39:13Z
"Vile ashes",31898,37344,0,5446,778,2025-08-07T18:36:45Z
"Eternal boots",4283069,4306112,87879,23043,1,2025-08-07T18:32:40Z
"Amethyst dart",2766687,2593227,52038,-173460,8673,2025-08-07T18:31:49Z
"Chaos rune",1242000,1260000,18000,18000,18000,2025-08-07T18:26:55Z
"Vial of blood",162204,162554,3304,350,14,2025-08-07T18:20:28Z
"Atlatl dart",530082,605808,8414,75726,8414,2025-08-07T18:01:19Z
"Red chinchompa",193312,196224,3808,2912,224,2025-08-07T18:00:26Z
"Adamant bolts",316896,323498,3301,6602,3301,2025-08-07T17:57:12Z
"Death rune",3575000,3625000,50000,50000,25000,2025-08-07T17:56:46Z
"Baby impling jar",789,775,15,-14,1,2025-08-07T17:47:25Z
"Soul rune",8060228,8099836,158432,39608,19804,2025-08-07T17:40:06Z
"Broad bolts",353280,404480,5120,51200,5120,2025-08-07T17:40:01Z
"Quetzal feed",637600,708900,14400,71300,100,2025-08-07T17:39:20Z
"Iron ore",1625000,1638000,26000,13000,13000,2025-08-07T17:36:30Z
"Dragon crossbow",7774872,7785492,158885,10620,7,2025-08-07T17:35:11Z
"Rune arrow",1683000,1738000,33000,55000,11000,2025-08-07T17:31:37Z
"Ruby bolts (e)",430652,458738,4681,28086,4681,2025-08-07T17:24:16Z
"Adamant dart",48544,57728,0,9184,1312,2025-08-07T17:13:35Z
"Bandos d'hide boots",439571,453656,9258,14085,1,2025-08-07T17:12:26Z
"Rune crossbow",58470,60750,1236,2280,6,2025-08-07T17:09:09Z
"Law rune",2052000,2070000,36000,18000,18000,2025-08-07T17:09:09Z
"Amethyst arrow",1352344,1379609,27265,27265,5453,2025-08-07T17:07:48Z
"Dragon chainbody",368304,362314,7394,-5990,1,2025-08-07T16:56:05Z
"Astral rune",530019,563671,8413,33652,8413,2025-08-07T16:53:46Z
"Blue moon chestplate",1951600,1990476,40620,38876,2,2025-08-07T16:50:31Z
"Mithril dart tip",1740000,1780000,20000,40000,20000,2025-08-07T16:45:52Z
"Willow longbow (u)",59512,65048,692,5536,692,2025-08-07T16:43:24Z
"Sanfew serum(4)",4721112,4739688,96552,18576,216,2025-08-07T16:41:57Z
"Armadyl d'hide boots",734938,745537,15215,10599,1,2025-08-07T16:35:20Z
"Ahrim's hood",323586,333711,6809,10125,2,2025-08-07T16:28:01Z
"Revenant ether",5250000,5310000,90000,60000,30000,2025-08-07T16:18:28Z
"Gold bar",1100000,1200000,20000,100000,10000,2025-08-07T16:14:42Z
"Demon tear",2925000,3029000,52000,104000,13000,2025-08-07T15:39:45Z
"Amethyst dart",714389,735332,13962,20943,2327,2025-08-07T15:39:16Z
"Occult ornament kit",3857529,3913672,79870,56143,1,2025-08-07T15:30:48Z
"Adamantite ore",2967552,3007872,60480,40320,4032,2025-08-07T15:27:44Z
"Stamina potion(4)",191520,192297,3906,777,21,2025-08-07T15:21:09Z
"Runite bolts",1595000,1617000,22000,22000,11000,2025-08-07T15:18:03Z
"Vial of blood",5674200,5721240,116620,47040,490,2025-08-07T15:02:52Z
"Nature rune",1638000,1656000,18000,18000,18000,2025-08-07T15:02:22Z
"Blood rune",5150000,5225000,100000,75000,25000,2025-08-07T14:47:17Z
"Coal",2301000,2340000,39000,39000,13000,2025-08-07T14:46:46Z
"Falador teleport",1208535,1237350,0,28815,1695,2025-08-07T14:42:31Z
"Adamant dart",266,266,0,0,7,2025-08-07T14:28:44Z
"Cosmic rune",1260000,1278000,18000,18000,18000,2025-08-07T14:22:14Z
"Young impling jar",537040,550863,10817,13823,560,2025-08-07T14:15:32Z
"Diamond bolts (e)",1925000,1991000,33000,66000,11000,2025-08-07T14:02:57Z
"Revenant ether",5220000,5310000,90000,90000,30000,2025-08-07T13:56:25Z
"Chaos rune",1206000,1242000,18000,36000,18000,2025-08-07T13:46:52Z
"Cannonball",2069925,2091375,32175,21450,10725,2025-08-07T13:46:48Z
"Blighted anglerfish",1870000,1860000,30000,-10000,10000,2025-08-07T13:43:43Z
"Death rune",3575000,3650000,50000,75000,25000,2025-08-07T13:39:10Z
"Atlatl dart",649000,693000,11000,44000,11000,2025-08-07T13:35:18Z
"Cannonball",52800,53900,825,1100,275,2025-08-07T13:31:41Z
"Warrior ring",205724,284956,5812,79232,4,2025-08-07T13:29:19Z
"Zulrah's scales",4527780,4598160,70380,70380,23460,2025-08-07T13:28:53Z
"Rune arrow",1694000,1749000,33000,55000,11000,2025-08-07T13:26:50Z
"Master wand",1699997,1735481,35417,35484,1,2025-08-07T13:07:44Z
"Zulrah's scales",500802,511290,7866,10488,2622,2025-08-07T13:06:54Z
"Vial of blood",7529760,7544139,153621,14379,672,2025-08-07T13:03:15Z
"Coal",2262000,2301000,39000,39000,13000,2025-08-07T05:48:14Z
"Yew longbow",7758410,7866595,154550,108185,15455,2025-08-07T05:41:08Z
"Mahogany logs",1424611,1470898,25715,46287,5143,2025-08-07T05:36:01Z
"Crystal weapon seed",1320784,1364480,27844,43696,4,2025-08-07T05:14:25Z
"Blue moon tassets",2044152,2072703,42300,28551,1,2025-08-07T05:14:25Z
"Emerald ring",1023768,1045008,21240,21240,1416,2025-08-07T05:10:19Z