item_name,spent,received_post_tax,tax_paid,profit,closed_quantity,closed_timestamp
"Marrentill potion (unf)",6264,7047,116,783,29,2025-07-29T04:53:19Z
"Maple shortbow (u)",23760,24480,360,720,360,2025-07-29T04:38:00Z
"Iron dart tip",27852,29751,0,1899,633,2025-07-29T04:31:35Z
"Maple sapling",53310,55770,1125,2460,15,2025-07-29T04:10:50Z
"Tai bwo wannai teleport",54090,58200,1185,4110,15,2025-07-29T04:03:23Z
"Molten glass",53375,56000,875,2625,875,2025-07-29T04:02:30Z
"Iron arrowtips",5445,6655,0,1210,605,2025-07-29T04:02:22Z
"Swampbark body",80549,83735,1708,3186,1,2025-07-29T03:57:51Z
"Bass",21627,24300,0,2673,243,2025-07-29T03:54:28Z
"Watchtower teleport",11997,13392,248,1395,31,2025-07-29T03:47:23Z
"Khazard teleport",6960,8154,162,1194,6,2025-07-29T03:46:08Z
"Mind altar teleport",1803,2029,41,226,1,2025-07-29T03:45:31Z
"Bass",1936,2244,0,308,22,2025-07-29T03:45:19Z
"West ardougne teleport",41235,43425,885,2190,15,2025-07-29T03:39:56Z
"Mystic hat",34160,36844,750,2684,2,2025-07-29T03:36:52Z
"Lava scale shard",6272,7616,0,1344,448,2025-07-29T03:34:58Z
"Pest control teleport",2063,2230,45,167,1,2025-07-29T03:34:04Z
"Bass",5720,6500,0,780,65,2025-07-29T03:32:11Z
"Tai bwo wannai teleport",18210,19410,395,1200,5,2025-07-29T03:28:13Z
"Blighted entangle sack",45072,47576,626,2504,626,2025-07-29T03:25:44Z
"Mind altar teleport",15732,18006,363,2274,9,2025-07-29T03:25:15Z
"Fenkenstrain's castle teleport",26470,28840,580,2370,10,2025-07-29T03:24:26Z
"Unicorn horn dust",3072,3204,64,132,4,2025-07-29T03:21:21Z
"Fenkenstrain's castle teleport",42352,45920,928,3568,16,2025-07-29T03:18:56Z
"Mystic gloves",34764,37332,756,2568,6,2025-07-29T03:16:44Z
"Ghorrock teleport",12324,14364,288,2040,12,2025-07-29T03:15:15Z
"Arceuus library teleport",13272,14336,287,1064,7,2025-07-29T03:10:29Z
"Feldip hills teleport",13030,15070,300,2040,10,2025-07-29T03:09:57Z
"Mystic hat",34558,37060,756,2502,2,2025-07-29T03:05:27Z
"Mind altar teleport",19316,21989,440,2673,11,2025-07-29T03:05:12Z
"Watermelon seed",1960,4592,56,2632,56,2025-07-29T03:03:38Z
"Xerician hat",38759,41496,840,2737,7,2025-07-29T03:01:58Z
"Searing page",39162,40542,825,1380,3,2025-07-29T03:01:54Z
"Hunter potion(4)",21448,24213,490,2765,7,2025-07-29T03:01:24Z
"Mystic hat",33464,36870,752,3406,2,2025-07-29T02:57:18Z
"Blighted entangle sack",31780,34504,454,2724,454,2025-07-29T02:54:44Z
"Maple bird house",6307,11921,238,5614,7,2025-07-29T02:51:53Z
"Xerician hat",33366,35418,720,2052,6,2025-07-29T02:51:42Z
"Mixed hide boots",14431,16088,328,1657,1,2025-07-29T02:49:33Z
"Ghorrock teleport",6186,7248,144,1062,6,2025-07-29T02:40:27Z
"Combat potion(4)",25250,28583,505,3333,101,2025-07-29T02:39:20Z
"Bass",15486,16878,0,1392,174,2025-07-29T02:35:30Z
"Blighted entangle sack",24220,26296,346,2076,346,2025-07-29T02:31:16Z
"Avantoe seed",2196,3969,72,1773,9,2025-07-29T02:30:34Z
"Yanillian hops",23268,24360,476,1092,28,2025-07-29T02:19:31Z
"Mystic hat",33790,36948,754,3158,2,2025-07-29T02:14:05Z
"Arceuus library teleport",9295,10290,205,995,5,2025-07-29T02:13:57Z
"Lassar teleport",19800,20768,418,968,22,2025-07-29T02:11:00Z
"Battlefront teleport",13788,14766,300,978,6,2025-07-29T02:05:07Z
"Cemetery teleport",2258,2774,56,516,1,2025-07-29T02:01:49Z
"Avantoe seed",2745,6585,120,3840,15,2025-07-29T01:53:59Z
"Colossal wyrm teleport scroll",34330,36190,738,1860,1,2025-07-29T01:52:44Z
"Fat snail",1619,2141,43,522,1,2025-07-29T01:42:56Z
"Ghorrock teleport",2052,2400,48,348,2,2025-07-29T01:36:41Z
"Senntisten teleport",18879,20769,420,1890,21,2025-07-29T01:35:09Z
"Apples(5)",3245,4851,88,1606,11,2025-07-29T01:35:04Z
"Iron dart",14160,24072,0,9912,1416,2025-07-29T01:29:13Z
"Lassar teleport",21528,22704,456,1176,24,2025-07-29T01:23:53Z
"Dragon arrow(p+)",12636,14418,294,1782,6,2025-07-29T01:20:30Z
"Iron dart",6530,9142,0,2612,653,2025-07-29T01:20:25Z
"Searing page",12102,13381,273,1279,1,2025-07-29T01:14:48Z
"Khazard teleport",3273,4068,81,795,3,2025-07-29T01:12:43Z
"Bolt of cloth",7200,7728,152,528,8,2025-07-29T01:12:40Z
"Apples(5)",22753,26352,488,3599,61,2025-07-29T01:11:22Z
"Bass",25317,28227,0,2910,291,2025-07-29T01:05:29Z
"Avantoe seed",1602,2622,48,1020,6,2025-07-29T01:05:19Z
"Limpwurt seed",1376,2150,0,774,86,2025-07-29T01:01:50Z
"Mystic gloves",17364,18645,378,1281,3,2025-07-29T00:58:25Z
"Kwuarm seed",8540,10680,215,2140,5,2025-07-29T00:56:05Z
"Carrallanger teleport",3234,3465,69,231,3,2025-07-29T00:52:32Z
"Monkey bar",8176,12048,240,3872,16,2025-07-29T00:52:17Z
"Black d'hide shield",18385,19644,400,1259,1,2025-07-29T00:48:32Z
"Wildblood seed",1581,2091,0,510,51,2025-07-29T00:47:19Z
"Bass",522,588,0,66,6,2025-07-29T00:46:55Z
"Senntisten teleport",5442,6000,120,558,6,2025-07-29T00:40:22Z
"Fat snail",1623,2220,45,597,1,2025-07-29T00:29:20Z
"Senntisten teleport",8980,10090,200,1110,10,2025-07-29T00:28:54Z
"Strawberries(5)",3663,5112,99,1449,9,2025-07-29T00:28:12Z
"Hunter potion(4)",14725,16235,330,1510,5,2025-07-29T00:21:14Z
"Waterskin(4)",1610,1990,40,380,10,2025-07-29T00:12:34Z
"Mystic gloves",16923,18606,378,1683,3,2025-07-29T00:07:17Z
"Feldip hills teleport",11826,12564,252,738,9,2025-07-29T00:05:15Z
"Magic potion(4)",10413,11303,178,890,89,2025-07-29T00:03:55Z
"Mahogany sapling",14812,20860,420,6048,14,2025-07-28T23:57:04Z
"Limestone brick",3880,4410,80,530,10,2025-07-28T23:56:19Z
"Steel axe",125,220,0,95,5,2025-07-28T23:54:05Z
"Apples(5)",5904,5728,112,-176,16,2025-07-28T23:47:55Z
"Khazard teleport",16688,20118,406,3430,14,2025-07-28T23:39:44Z
"Kebbit bolts",16653,17690,305,1037,61,2025-07-28T23:38:36Z
"Senntisten teleport",1770,2034,40,264,2,2025-07-28T23:35:27Z
"Limestone brick",5031,5733,104,702,13,2025-07-28T23:33:31Z
"Gianne dough",400,1200,0,800,200,2025-07-28T23:33:02Z
"Babydragon bones",11400,12576,240,1176,24,2025-07-28T23:30:44Z
"Dragon scale dust",648,744,12,96,12,2025-07-28T23:26:02Z
"Waterskin(4)",4316,5174,104,858,26,2025-07-28T23:24:53Z
"Moonlight moth mix (2)",14615,15230,310,615,5,2025-07-28T23:18:22Z
"Magic potion(4)",8307,9017,142,710,71,2025-07-28T23:16:59Z
"Iron arrowtips",4800,6000,0,1200,600,2025-07-28T23:07:11Z
"Mole claw",4801,5888,120,1087,1,2025-07-28T23:03:27Z
"Apples(5)",8924,10557,207,1633,23,2025-07-28T22:58:20Z
"Mahogany bird house",12376,13237,266,861,7,2025-07-28T22:51:36Z
"Admiral pie",3800,4408,76,608,38,2025-07-28T22:42:31Z
"Pot of cream",3312,1242,0,-2070,207,2025-07-28T22:36:07Z
"Blue d'hide vambraces",12488,14264,288,1776,8,2025-07-28T22:29:53Z
"Cup of hot water",13585,15990,325,2405,65,2025-07-28T22:23:09Z
"Senntisten teleport",7956,8802,171,846,9,2025-07-28T22:19:07Z
"Dragonfruit pie",8908,9486,187,578,17,2025-07-28T22:18:38Z
"Carrallanger teleport",8696,9437,187,741,8,2025-07-28T22:16:52Z
"Ghorrock teleport",12252,14544,288,2292,12,2025-07-28T22:12:03Z
"Waterskin(4)",5460,6000,120,540,30,2025-07-28T21:58:32Z
"Snakeskin boots",1290,2172,42,882,6,2025-07-28T21:39:52Z
"Khazard teleport",6525,7315,145,790,5,2025-07-28T21:37:11Z
"Lantadyme seed",2160,13140,180,10980,180,2025-07-28T21:35:50Z
"Hunter potion(4)",5838,6416,130,578,2,2025-07-28T21:33:42Z
"Cup of hot water",7210,8750,175,1540,35,2025-07-28T21:31:45Z
"Strawberries(5)",2235,3055,60,820,5,2025-07-28T21:31:41Z
"Mahogany bird house",4428,5418,108,990,3,2025-07-28T21:31:26Z
"Iron spit",646,1248,24,602,2,2025-07-28T21:26:09Z
"Ghorrock teleport",4124,4920,100,796,4,2025-07-28T21:17:09Z
"Mind altar teleport",3276,3856,78,580,2,2025-07-28T21:08:24Z
"Efaritay's aid",6430,7146,144,716,2,2025-07-28T21:07:30Z
"Admiral pie",99,120,2,21,1,2025-07-28T21:06:37Z
"Stew",876,1068,12,192,12,2025-07-28T20:58:59Z
"Blue d'hide vambraces",6268,7120,144,852,4,2025-07-28T20:56:41Z
"Kebbit bolts",6576,7248,144,672,24,2025-07-28T20:52:57Z
"Combat potion(4)",1315,1455,25,140,5,2025-07-28T20:48:25Z
"Mind altar teleport",1610,1934,39,324,1,2025-07-28T20:42:08Z
"Kebbit bolts",4675,5219,102,544,17,2025-07-28T20:30:59Z
"Cadava berries",528,576,8,48,4,2025-07-28T20:27:29Z
"Belladonna seed",468,1056,18,588,6,2025-07-28T20:19:55Z
"Amulet of defence",1692,2163,42,471,3,2025-07-28T20:12:08Z
"Senntisten teleport",1774,2020,40,246,2,2025-07-28T20:05:32Z
"Botanical pie",4083,5538,111,1455,3,2025-07-28T19:57:57Z
"Sapphire bolts",3956,4773,86,817,43,2025-07-28T19:56:18Z
"Strawberry seed",1620,2052,0,432,108,2025-07-28T19:49:03Z
"Adamant crossbow",702,2297,46,1595,1,2025-07-28T19:45:11Z
"Kharyrll teleport",2568,3066,60,498,3,2025-07-28T19:44:54Z
"Botanical pie",1005,1836,37,831,1,2025-07-28T19:34:57Z
"Kharyrll teleport",5064,6126,120,1062,6,2025-07-28T19:34:09Z
"Restore potion(4)",344,496,8,152,4,2025-07-28T19:28:09Z
"Stew",2106,2403,27,297,27,2025-07-28T19:27:49Z
"Chef's delight",326,408,8,82,1,2025-07-28T19:13:47Z
"Blue d'hide vambraces",4704,5352,108,648,3,2025-07-28T19:00:28Z
"Weapon poison(+)",2056,2406,48,350,2,2025-07-28T18:55:05Z
"Extended antifire(1)",1022,1274,14,252,14,2025-07-28T18:45:04Z
"Pineapple sapling",3509,4070,77,561,11,2025-07-28T18:41:17Z
"Bronze axe",574,1134,14,560,14,2025-07-28T18:40:51Z
"Limestone brick",1960,2215,45,255,5,2025-07-28T18:39:09Z
"Iron arrowtips",840,1260,0,420,140,2025-07-28T18:28:52Z
"Willow bird house",3255,3912,78,657,3,2025-07-28T18:28:03Z
"Combat potion(4)",783,888,18,105,3,2025-07-28T18:14:05Z
"Moonclan teleport",2212,2784,56,572,4,2025-07-28T18:06:44Z
"Antidote++(1)",680,983,20,303,1,2025-07-28T18:06:20Z
"Olive oil(4)",148,176,2,28,2,2025-07-28T18:06:19Z
"Avantoe seed",1143,2592,45,1449,9,2025-07-28T17:51:55Z
"Iron arrowtips",1106,1422,0,316,158,2025-07-28T17:48:29Z
"Guam seed",1040,1480,20,440,20,2025-07-28T17:45:13Z
"Calcite",860,980,10,120,10,2025-07-28T17:34:26Z
"Soiled page",1116,1521,30,405,3,2025-07-28T17:26:17Z
"Hunters' crossbow",221,2458,50,2237,1,2025-07-28T17:24:08Z
"Weapon poison(+)",1044,1269,25,225,1,2025-07-28T17:24:02Z
"Dragon scale dust",1325,1575,25,250,25,2025-07-28T17:19:33Z
"Oak longbow (u)",480,672,0,192,32,2025-07-28T17:17:57Z
"Fishing potion(4)",1644,2088,36,444,12,2025-07-28T17:17:14Z
"Soiled page",386,549,11,163,1,2025-07-28T17:04:50Z
"Apples(5)",1005,1323,24,318,3,2025-07-28T17:00:48Z
"Chocolate bar",116,132,2,16,2,2025-07-28T16:57:34Z
"Raw kyatt",1110,1360,20,250,10,2025-07-28T16:39:08Z
"Iron dart",750,975,0,225,75,2025-07-28T16:38:55Z
"Limpwurt seed",578,850,0,272,34,2025-07-28T16:38:07Z
"Olive oil(4)",300,388,4,88,4,2025-07-28T16:35:43Z
"Stony basalt",999,1175,23,176,1,2025-07-28T16:35:24Z
"Agility potion(4)",532,668,12,136,2,2025-07-28T16:19:45Z
"Snakeskin bandana",1065,1385,25,320,5,2025-07-28T16:19:23Z
"Unlit torch",180,240,0,60,12,2025-07-28T16:18:27Z
"Longbow",144,288,0,144,48,2025-07-28T15:50:19Z
"Steel med helm",46,146,2,100,2,2025-07-28T15:44:02Z
"Dareeyak teleport",1312,1564,30,252,2,2025-07-28T15:33:55Z
"Pie dish",288,1296,0,1008,72,2025-07-28T15:24:29Z
"Beer",456,522,6,66,6,2025-07-28T15:12:09Z
"Pie dish",80,288,0,208,16,2025-07-28T15:11:21Z
"Black cape",161,202,4,41,1,2025-07-28T15:10:29Z
"Dragon scale dust",648,756,12,108,12,2025-07-28T15:06:30Z
"Apples(5)",328,403,8,75,1,2025-07-28T15:03:36Z
"Oak shortbow",22,26,0,4,2,2025-07-28T14:54:42Z
"Agility potion(4)",265,344,7,79,1,2025-07-28T14:52:17Z
"Snakeskin bandana",812,1132,20,320,4,2025-07-28T14:50:44Z
"Iron axe",162,192,0,30,6,2025-07-28T14:46:28Z
"Apples(5)",730,854,16,124,2,2025-07-28T14:42:44Z
"Raw kyatt",565,765,15,200,5,2025-07-28T14:40:16Z
"Amethyst javelin",105,125,2,20,1,2025-07-28T14:33:56Z
"Hunters' crossbow",41,485,9,444,1,2025-07-28T14:25:11Z
"Tinderbox",134,144,2,10,2,2025-07-28T14:23:15Z
"Sapphire bolts",340,456,8,116,4,2025-07-28T14:17:18Z
"Barley seed",186,217,0,31,31,2025-07-28T14:16:02Z
"Snakeskin bandana",404,568,10,164,2,2025-07-28T14:13:48Z
"Snakeskin bandana",432,558,10,126,2,2025-07-28T14:10:07Z
"Apple sapling",492,876,15,384,3,2025-07-28T14:04:49Z
"Supercompost",490,700,0,210,35,2025-07-28T14:04:31Z
"Yanillian seed",264,352,0,88,44,2025-07-28T14:01:08Z
"Iron chainbody",108,166,2,58,2,2025-07-28T13:50:21Z
"Iron axe",24,42,0,18,1,2025-07-28T13:43:49Z
"Attack potion(4)",364,420,0,56,28,2025-07-28T13:42:48Z
"Opal",178,220,4,42,1,2025-07-28T13:41:58Z
"Asgarnian seed",120,168,0,48,24,2025-07-28T13:35:13Z
"Restore potion(4)",77,132,2,55,1,2025-07-28T13:32:54Z
"Bag of salt",198,225,0,27,9,2025-07-28T13:00:58Z
"Tomatoes(5)",290,313,6,23,1,2025-07-28T12:35:14Z
"Iron full helm",103,220,4,117,1,2025-07-28T12:34:34Z
"Olive oil(4)",74,97,1,23,1,2025-07-28T12:31:44Z
"Watermelon seed",63,276,3,213,3,2025-07-28T10:59:26Z
"Blue firelighter",28,119,0,91,7,2025-07-28T10:51:13Z