item_name,spent,received_post_tax,tax_paid,profit,closed_quantity,closed_timestamp
"Toktz-ket-xil",1619559,1658543,33847,38984,3,2025-08-07T04:59:56Z
"Death rune",1578495,1600885,22390,22390,11195,2025-08-07T04:59:01Z
"Eclipse atlatl",5303328,5350052,109183,46724,3,2025-08-07T04:58:58Z
"Soul rune",2419644,2449224,47328,29580,5916,2025-08-07T04:58:20Z
"Armadyl godsword",9050023,9128430,186294,78407,1,2025-08-07T04:55:16Z
"Chaos rune",1188000,1224000,18000,36000,18000,2025-08-07T04:48:21Z
"Rune arrow",1065305,1114690,21165,49385,7055,2025-08-07T04:46:30Z
"Dragonfire shield",7550730,7603152,155166,52422,2,2025-08-07T04:44:35Z
"Crystal weapon seed",660960,674782,13770,13822,2,2025-08-07T04:43:33Z
"Dragon felling axe",2145950,2232242,45555,86292,1,2025-08-07T04:32:23Z
"Rune dart",219079,226576,4165,7497,833,2025-08-07T04:31:57Z
"Rune arrow",587805,615420,11835,27615,3945,2025-08-07T04:28:03Z
"Toxic staff (uncharged)",11792078,11884705,242544,92627,1,2025-08-07T04:19:28Z
"Soul rune",7805356,7919860,152672,114504,19084,2025-08-07T04:18:18Z
"Divine magic potion(4)",468174,489336,9936,21162,71,2025-08-07T04:17:32Z
"Ornate maul handle",4728648,4773231,97409,44583,8,2025-08-07T04:13:30Z
"Quetzal feed",473480,551622,11214,78142,89,2025-08-07T04:12:31Z
"Zamorakian hasta",1752883,1759386,35905,6503,1,2025-08-07T04:07:29Z
"Burnt page",1757142,1777788,36270,20646,558,2025-08-07T03:55:48Z
"White berries",1210560,1245480,23280,34920,3880,2025-08-07T03:54:55Z
"Pharaoh's sceptre (uncharged)",5728640,5839990,119182,111350,2,2025-08-07T03:41:44Z
"Zamorak d'hide boots",581416,602236,12290,20820,1,2025-08-07T03:37:32Z
"Snape grass seed",423940,468985,9570,45045,55,2025-08-07T03:27:55Z
"Emerald ring",401988,411440,8340,9452,556,2025-08-07T03:26:41Z
"Ranarr seed",3408913,3464339,70620,55426,107,2025-08-07T03:24:19Z
"Falador teleport",741240,765735,0,24495,1065,2025-08-07T03:21:34Z
"Holy sandals",1031698,1065228,21739,33530,1,2025-08-07T03:18:49Z
"Mage's book",5769906,5868232,119758,98326,2,2025-08-07T03:12:43Z
"Dragon knife",4364325,4467330,91035,103005,315,2025-08-07T03:07:39Z
"Saradomin d'hide boots",429939,449281,9168,19342,1,2025-08-07T03:04:30Z
"Blighted super restore(4)",3828000,3852000,78000,24000,2000,2025-08-07T03:01:43Z
"Accursed sceptre (u)",3869309,3930469,80213,61160,1,2025-08-07T03:01:03Z
"Cannonball",1108296,1120024,17592,11728,5864,2025-08-07T02:58:11Z
"Ring of the gods",1133298,1217559,24848,84261,1,2025-08-07T02:55:01Z
"Dark crab",239625,243875,4875,4250,125,2025-08-07T02:51:21Z
"Mahogany logs",289800,299250,5250,9450,1050,2025-08-07T02:50:48Z
"Vial of blood",7703020,7782255,158470,79235,689,2025-08-07T02:50:31Z
"Cadantine potion (unf)",3792896,3785728,76800,-7168,1024,2025-08-07T02:50:06Z
"Antidote++(4)",2958345,2933533,59457,-24812,845,2025-08-07T02:48:51Z
"Wilderness crabs teleport",1519663,1536906,31347,17243,43,2025-08-07T02:44:46Z
"Blood rune",5100000,5200000,100000,100000,25000,2025-08-07T02:33:33Z
"Red chinchompa",6048000,6153000,119000,105000,7000,2025-08-07T02:32:24Z
"Cannonball",937368,952326,14958,14958,4986,2025-08-07T02:29:24Z
"Law rune",2052000,2106000,36000,54000,18000,2025-08-07T02:28:32Z
"Accursed sceptre (u)",3889999,3936948,80345,46949,1,2025-08-07T02:22:09Z
"Manta ray",7098574,6961216,141152,-137358,1897,2025-08-07T02:11:12Z
"Yew longbow (u)",2337215,2390856,45978,53641,7663,2025-08-07T02:10:35Z
"Astral rune",1575000,1650000,25000,75000,25000,2025-08-07T02:09:40Z
"Blue moon spear",403054,417230,8514,14176,2,2025-08-07T02:01:20Z
"Runite bolts",986537,1000939,14402,14402,7201,2025-08-07T02:00:51Z
"Varrock teleport",1989532,2026000,0,36468,4052,2025-08-07T01:55:41Z
"Lava rune",252000,270000,0,18000,18000,2025-08-07T01:50:41Z
"Cannonball",27600,28650,450,1050,150,2025-08-07T01:50:05Z
"Gold bar",1240000,1230000,20000,-10000,10000,2025-08-07T01:45:49Z
"Yew logs",1434792,1487376,30048,52584,7512,2025-08-07T01:38:03Z
"Accursed sceptre (au)",3939375,3999566,81623,60191,1,2025-08-07T01:33:12Z
"Shark",7038228,7187343,139174,149115,9941,2025-08-07T01:28:12Z
"Divine ranging potion(4)",171057,175826,3572,4769,19,2025-08-07T01:26:46Z
"Nature rune",1566000,1602000,18000,36000,18000,2025-08-07T01:23:29Z
"Runite bolts",181194,186446,2626,5252,1313,2025-08-07T01:14:57Z
"Manta ray",2347951,2377571,47993,29620,631,2025-08-07T01:11:26Z
"Zulrah's scales",5317632,5373024,83088,55392,27696,2025-08-07T01:09:58Z
"Bones to peaches",111900,119100,2400,7200,100,2025-08-07T01:05:35Z
"Adamant bolts",1056000,1078000,11000,22000,11000,2025-08-07T01:03:18Z
"Obsidian platebody",1956706,1991148,40634,34442,2,2025-08-07T00:56:51Z
"Adamant dart",330000,363000,0,33000,11000,2025-08-07T00:56:25Z
"Ranarr seed",2938986,2951076,60171,12090,93,2025-08-07T00:55:41Z
"Warrior ring",139006,160004,3264,20998,2,2025-08-07T00:54:58Z
"Runite bolts",340582,350526,4972,9944,2486,2025-08-07T00:48:31Z
"Steel arrowtips",315,300,0,-15,15,2025-08-07T00:47:39Z
"Infinity boots",1041872,1055577,21539,13705,4,2025-08-07T00:47:09Z
"Death rune",2599594,2636208,36614,36614,18307,2025-08-07T00:44:36Z
"Atlatl dart",605000,693000,11000,88000,11000,2025-08-07T00:40:15Z
"Teleport to house",627198,631686,0,4488,1122,2025-08-07T00:37:37Z
"Antler guard",3425694,3478430,70988,52736,1,2025-08-07T00:36:31Z
"Bottomless compost bucket",2526376,2560390,52252,34014,2,2025-08-07T00:34:35Z
"Red spiders' eggs",2223000,2236000,39000,13000,13000,2025-08-07T00:27:00Z
"Chaos rune",1188000,1242000,18000,54000,18000,2025-08-07T00:23:49Z
"Soul rune",4828558,4911809,95144,83251,11893,2025-08-07T00:22:49Z
"Revenant ether",5220000,5280000,90000,60000,30000,2025-08-07T00:17:36Z
"Snape grass seed",1266572,1290188,26240,23616,164,2025-08-07T00:17:04Z
"Blue moon tassets",3945346,4036720,82382,91374,2,2025-08-07T00:04:11Z
"Rune arrow",1661000,1705000,33000,44000,11000,2025-08-07T00:00:59Z
"Zamorakian hasta",1702282,1731813,35343,29531,1,2025-08-06T23:59:59Z
"Dragon bones",5475925,5543321,110722,67396,2407,2025-08-06T23:59:39Z
"Death rune",943713,957099,13386,13386,6693,2025-08-06T23:58:52Z
"Cosmic rune",1296000,1332000,18000,36000,18000,2025-08-06T23:58:48Z
"Amethyst arrow",1142240,1161120,23600,18880,4720,2025-08-06T23:54:47Z
"Cannonball",2024000,2079000,33000,55000,11000,2025-08-06T23:54:07Z
"Ahrim's armour set",3552008,3595979,73387,43971,1,2025-08-06T23:51:53Z
"Soul rune",5400084,5400084,104856,0,13107,2025-08-06T23:48:18Z
"Eclipse moon chestplate",1886794,1921820,39220,35026,2,2025-08-06T23:44:51Z
"Coal",2236000,2275000,39000,39000,13000,2025-08-06T23:38:55Z
"Amethyst dart",3553000,3641000,66000,88000,11000,2025-08-06T23:35:00Z
"Varrock teleport",2441463,2461851,0,20388,5097,2025-08-06T23:32:22Z
"Dagon'hai robe bottom",668941,681069,13899,12128,1,2025-08-06T23:24:08Z
"Rangers' tights",514531,541400,11048,26869,1,2025-08-06T23:17:21Z
"Teleport to house",4934500,4987750,0,53250,8875,2025-08-06T23:15:34Z
"Gold bar",1220000,1240000,20000,20000,10000,2025-08-06T23:09:28Z
"Iron bar",1547700,1575840,28140,28140,7035,2025-08-06T22:04:26Z
"Blighted super restore(4)",4060000,4064000,82000,4000,2000,2025-08-06T22:04:26Z
"Runite bolts",901984,927392,12704,25408,6352,2025-08-06T21:19:26Z
"Amulet of avarice",2136954,2195730,44808,58776,6,2025-08-06T21:06:57Z
"Astral rune",1525000,1675000,25000,150000,25000,2025-08-06T21:06:28Z
"Accursed sceptre (u)",3856326,3902825,79649,46499,1,2025-08-06T21:03:45Z
"Eclipse moon tassets",848881,875237,17861,26356,1,2025-08-06T20:57:31Z
"Blood rune",5100000,5150000,100000,50000,25000,2025-08-06T20:55:06Z
"Falador teleport",1436000,1470000,0,34000,2000,2025-08-06T20:46:51Z
"Runite bolts",641424,660016,9296,18592,4648,2025-08-06T20:44:52Z
"Dragon bones",7058859,7149078,143106,90219,3111,2025-08-06T20:44:34Z
"Yew sapling",453491,465152,9476,11661,23,2025-08-06T20:43:57Z
"Adamant dart",338520,371280,0,32760,10920,2025-08-06T20:41:58Z
"Snape grass seed",270864,284040,5796,13176,36,2025-08-06T20:40:22Z
"Blighted anglerfish",154328,158368,2424,4040,808,2025-08-06T20:39:48Z
"Nature rune",1584000,1602000,18000,18000,18000,2025-08-06T20:31:37Z
"Red chinchompa",5971000,6041000,119000,70000,7000,2025-08-06T20:31:21Z
"Mage's book",2795167,2816087,57471,20920,1,2025-08-06T20:23:28Z
"Law rune",2034000,2088000,36000,54000,18000,2025-08-06T20:17:44Z
"Mage's book",5584716,5640886,115120,56170,2,2025-08-06T20:17:16Z
"Blood moon helm",853449,887917,18120,34468,1,2025-08-06T20:15:17Z
"Maple longbow (u)",1150366,1059786,18116,-90580,9058,2025-08-06T20:03:40Z
"Verac's plateskirt",448028,480312,9802,32284,2,2025-08-06T19:58:43Z
"Chaos rune",1098000,1170000,18000,72000,18000,2025-08-06T19:56:14Z
"Lava dragon bones",613038,630468,12782,17430,166,2025-08-06T19:55:32Z
"Unpowered orb",673812,663903,9909,-9909,9909,2025-08-06T19:44:34Z
"Barrows teleport",164252,166936,3388,2684,44,2025-08-06T19:42:35Z
"Oak plank",5616000,5655000,104000,39000,13000,2025-08-06T19:35:51Z
"Dwarf cannon set",3023160,3055052,62344,31892,4,2025-08-06T19:25:46Z
"Rune arrow",1683000,1683000,33000,0,11000,2025-08-06T19:23:33Z
"Verac's plateskirt",222733,239972,4897,17239,1,2025-08-06T19:23:24Z
"Coal",2249000,2236000,39000,-13000,13000,2025-08-06T19:10:04Z
"Cosmic rune",1314000,1368000,18000,54000,18000,2025-08-06T19:07:55Z
"Zulrah's scales",5760000,5790000,90000,30000,30000,2025-08-06T19:00:07Z
"Adamant dart",2080,2560,0,480,80,2025-08-06T18:49:03Z
"Mahogany logs",3036000,3069000,55000,33000,11000,2025-08-06T18:48:17Z
"Mixed hide top",475328,494976,10080,19648,32,2025-08-06T18:43:03Z
"Adamant bolts",1177000,1221000,22000,44000,11000,2025-08-06T18:37:55Z
"Blighted entangle sack",414290,438660,4874,24370,4874,2025-08-06T18:37:41Z
"Kwuarm seed",288320,333120,6720,44800,160,2025-08-06T18:31:47Z
"Rune dart",2970000,3069000,55000,99000,11000,2025-08-06T18:17:09Z
"Law rune",1998000,1980000,36000,-18000,18000,2025-08-06T18:03:39Z
"Accursed sceptre (u)",3899995,3951254,80637,51259,1,2025-08-06T17:58:23Z
"Bandos d'hide boots",370853,417962,8529,47109,1,2025-08-06T17:56:19Z
"Malediction ward",2116350,2144218,43759,27868,1,2025-08-06T17:54:49Z
"Cadantine seed",294945,333423,6678,38478,159,2025-08-06T17:53:00Z
"Numulite",1247,1247,0,0,43,2025-08-06T17:52:34Z
"Molten glass",910000,897000,13000,-13000,13000,2025-08-06T17:50:01Z
"Dragon platebody",2394221,2419709,49381,25488,1,2025-08-06T17:46:22Z
"Torstol seed",1555600,1620822,32978,65222,200,2025-08-06T17:32:18Z
"Lava dragon bones",5864184,5908900,119775,44716,1597,2025-08-06T17:31:16Z
"Rune dart tip",809190,833976,16767,24786,729,2025-08-06T17:21:56Z
"Dragon dart",2449308,2486484,49440,37176,1604,2025-08-06T17:15:58Z
"Atlatl dart",539000,561000,11000,22000,11000,2025-08-06T17:11:44Z
"Revenant ether",5280000,5310000,90000,30000,30000,2025-08-06T17:05:01Z
"Berserker necklace",4694788,4743358,96802,48570,2,2025-08-06T17:03:18Z
"Cannonball",1213296,1233078,19782,19782,6594,2025-08-06T16:53:32Z
"Blood rune",5100000,5150000,100000,50000,25000,2025-08-06T16:45:09Z
"Diamond dragon bolts (e)",1645634,1668805,34017,23171,493,2025-08-06T16:41:50Z
"Devout boots",1150347,1162774,23730,12427,1,2025-08-06T16:37:21Z
"Ranarr seed",5906400,5964000,121600,57600,200,2025-08-06T16:36:18Z
"Mithril dart tip",1740000,1800000,20000,60000,20000,2025-08-06T16:36:03Z
"Eclipse moon helm",484587,493429,10069,8842,1,2025-08-06T16:33:15Z
"Amethyst dart",3663000,3773000,66000,110000,11000,2025-08-06T16:08:01Z
"Blue moon tassets",1945565,1979288,40393,33723,1,2025-08-06T16:05:45Z
"Ring of dueling(8)",290358,295488,0,5130,513,2025-08-06T16:05:34Z
"Cannonball",810704,823922,13218,13218,4406,2025-08-06T15:59:50Z
"Uncut ruby",2628591,2597856,51492,-30735,1887,2025-08-06T15:46:22Z
"Nature rune",1566000,1584000,18000,18000,18000,2025-08-06T15:29:44Z
"Trouver parchment",5402992,5446176,111144,43184,8,2025-08-06T15:03:54Z
"Chaos rune",1080000,1098000,18000,18000,18000,2025-08-06T15:00:02Z
"Rune pouch note",2769978,2815468,57458,45490,1,2025-08-06T14:59:19Z
"Ahrim's robetop",1637062,1646999,33612,9937,1,2025-08-06T14:58:42Z
"Sapphire dragon bolts (e)",108420,109395,2223,975,39,2025-08-06T14:54:18Z
"Sapphire dragon bolts (e)",2785560,2812614,57114,27054,1002,2025-08-06T14:53:07Z
"Ardougne teleport",2536,2580,0,44,4,2025-08-06T14:46:31Z
"Rune arrow",1815000,1826000,33000,11000,11000,2025-08-06T14:46:16Z
"Torag's platelegs",235551,241403,4926,5852,1,2025-08-06T14:33:40Z
"Wilderness crabs teleport",1602962,1610701,32833,7739,46,2025-08-06T14:27:14Z
"Mithril bar",26670,27020,525,350,35,2025-08-06T14:20:25Z
"Odium ward",5852643,5927230,120963,74587,1,2025-08-06T14:12:08Z
"Zamorak d'hide boots",574888,753274,15372,178386,1,2025-08-06T14:10:11Z
"Eternal boots",4237647,4285062,87450,47415,1,2025-08-06T14:08:44Z
"Virtus mask",6455266,6173812,125996,-281454,1,2025-08-06T14:07:22Z
"Cosmic rune",1188000,1350000,18000,162000,18000,2025-08-06T14:06:47Z
"Spiked manacles",718136,726743,14831,8607,1,2025-08-06T13:59:14Z
"Antler guard",3339752,3412759,69648,73007,1,2025-08-06T13:58:51Z
"Chaos rune",1008000,1080000,18000,72000,18000,2025-08-06T13:46:50Z
"Ring of the gods",2165610,2161008,44102,-4602,2,2025-08-06T06:18:06Z
"Cannonball",1688388,1923480,32058,235092,10686,2025-08-06T06:13:47Z
"Soul rune",6443560,6537856,125728,94296,15716,2025-08-06T06:13:09Z
"Blighted manta ray",662448,666000,12432,3552,1776,2025-08-06T06:03:32Z
"Yew longbow (u)",12978,13692,252,714,42,2025-08-06T05:57:49Z
"Occult ornament kit",3866157,3897080,79532,30923,1,2025-08-06T05:37:55Z
"Impling jar",6415392,6423254,125792,7862,7862,2025-08-06T05:29:38Z
"Runite bolts",148508,153928,2168,5420,1084,2025-08-06T05:29:07Z
"Guthix d'hide boots",402259,413031,8429,10772,1,2025-08-06T05:28:06Z
"Coal",142096,148944,2568,6848,856,2025-08-06T05:24:57Z
"Shark",4295236,4283580,81592,-11656,5828,2025-08-06T05:24:45Z
"Aldarium",1331775,1315080,26820,-16695,45,2025-08-06T05:21:55Z
"Diamond bolts (e)",518947,558675,9932,39728,2483,2025-08-06T05:04:28Z